1111111111111
100000C000001
10P1111111E01

100000C000001
1111111111111
