NO textures/green_fire.xpm
SO textures/skulls.xpm
WE textures/doom_2.xpm
EA textures/wall.xpm

F 46,66,37
C 023,73,35

111111111111111111111111
100000000000000000000001
100000000000001010100001
100000000N00000000000001
100000000000101010000001
100101010000000000000001
100000000000000000000001
100000111110000101010001
100000100010000000000001
100000100010000100010001
100000100010000000000001
100000111100001010100001
100000000000000000000001
100001010100000101010001
100000000000000000000001
100101010000101010000001
100000000000000000000001
101010100001010100000001
100000000000000101010001
111111111000000000000001
100100001000001010100001
100000101000000000000001
100100001000010101000001
100111111000000000000001
100000000000010101000001
100000000000000000000001
111111111111111111111111