NO textures/eagle.xpm
SO textures/ceramic.xpm
WE textures/brown_stone.xpm
EA textures/blue_stone.xpm

F 76,76,76
C 99,99,99

111111111111111111111111111
100000000000000000000000001
101111111111111111111111101
100000000000000000000000001
111110111111111111111011111
100010100000000000010000001
101110101111111111010111101
100000101000000001010000001
111110101011111101011111101
100000001010001000010000001
101111101011101110111111101
100000101000000010000000001
111110101111111011111101111
10000010100N001000000001001
101110101011101111111101101
100010000000000000000000001
101111111111111111111111101
100000000000000000000000001
111111111111111111111111111
