111111111111111111111111
1P011C1000000000000000E1
100110100111000010000001
1001101001C1000011000001
10011010000000C1111E0001
100110100000000010000001
1000000000000000000000C1
111111111111111111111111
