1111111111111
1000000000001
10P1111111E01
1000000000001
1111111111111
